



















NO	 ./path_to_the_north_texture
SO ./path_to_the_south_texture




WE ./path_to_the_west_texture

		 EA 	./path_to_the_east_texture
	    	  F 	 		   250,40,0		 
C 225,30,000		


 1111111111111111111
10001010000001
10S0100000011
100010000001
 1111111111
